NO ./assets/textures/CLAYBRICKS-1.xpm
SO ./assets/textures/REDBRICKS-1.xpm
WE ./assets/textures/ROUNDBRICKS-1.xpm
EA ./assets/textures/SLIMBRICKS-1.xpm

F 148,85,58
C 77,236,250

 111111111111111111111111111111111 
1000010000000000000000000000010001
1000010000000000000000000000010001
1000000000000000000000000000000001
1000000011110001111100000000E000001111
10000000001100011111100000000000000001
10000100000000000000000000000010001111
1000010000000000000000000100011111
10000100000000000000000000010001
 1111111111111111111111111111111