NO ./assets/textures/wallTexxtures0.xpm
SO ./assets/textures/wallTextures1.xpm
WE ./assets/textures/wallTextures2.xpm
EA ./assets/textures/wallTextures3.xpm

F 148,85,58
C 77,236,250

 11111111111111111111111 
1000010000000000000010001
1000010000000000000010001
1000000000000000000000001
100000000000000000E000001
1000000000000000000000001
1000010000000000000010001
1000010000000000000010001
1000010000000000000010001
 11111111111111111111111

