NO ./assets/textures/CLAYBRICKS-1.xpm
SO ./assets/textures/REDBRICKS-1.xpm
WE ./assets/textures/ROUNDBRICKS-1.xpm
EA ./assets/textures/SLIMBRICKS-1.xpm

F 148,85,58
C 77,236,250

1111111111111111111111111
1000010000000000000010001
1000010000000000000010001
1000000000000000000000001
100000000000000000E000001
1000000000000000000000001
1000010000000000000010001
1000010000000000000010001
1000010000000000000010001
1111111111111111111111111

