NO ./assets/textures/wallTextures0.xpm
SO ./assets/textures/wallTextures1.xpm
WE ./assets/textures/wallTextures2.xpm
EA ./assets/textures/wallTextures3.xpm

F 148,85,-58
C 77,236,250

1111111111111111111111111
1000000000000000000000001
1000010000000000000010001
1000010000000000000010001
10000000000N0000000000001
1111111111111111111111111
