NO ./assets/textures/CLAYBRICKS-1.xpm
SO ./assets/textures/REDBRICKS-1.xpm
WE ./assets/textures/ROUNDBRICKS-1.xpm
EA ./assets/textures/SLIMBRICKS-1.xpm

F 148,85,58
C 77,236,250

        1111111111111111111111111
        1000000000110000000000001
        111000001110000000W000001
        1001000000000000000000001
111111111011000001110000000000001
000000000011000001110111111111111
11110111111111011100000010001
11110111111111011101010010001
11000000110101011100000010001
10000000000000001100000010001
10000000000000001101010010001
11000001110101011111011110001
11110111 1110101 101111010001
11111111 1111111 111111111111